SSSSSSSSSD
S########S
S# E #  #S
S# CXXC #S
S# CXF ##S
S# CXXC #S
S#  #   #S
S########S
SSSSSSSSSS
SSSSSSSSSS

