SSSSSSSSSD
SS######SS
SS#    #SS
SS# C E#SS
SS##F  #SS
SS# F ##SS
SS# F #SSS
SS# F #SSS
SS# X #SSS
SS#####SSS
