SSSSSSSSSD
#####SSSSS
#   #####S
# # #   #S
# C   C #S
#XX#C#C##S
#XEC   #SS
#XX  ###SS
######SSSS
SSSSSSSSSS
