SSSSSSSSSD
SS#####SSS
### E  #SS
#   X ##SS
#  XCX #SS
### CC #SS
SS#   ##SS
OO#####SSS
SSSSSSSSSS
SSSSSSSSSS
