SSSSSSSSSD
SS#####SSS
SS# E ###S
S## #C  #S
S# FX X #S
S#  CC ##S
S### #X#SS
SSS#   #SS
SSS#####SS
SSSSSSSSSS