SSSSSSSSSD
S#######SS
S#XXCXX#SS
S#XX#XX#SS
S# CCC #SS
S#  C  #SS
S# CCC #SS
S#  # E#SS
S#######SS
SSSSSSSSSS

