SSSSSSSSSD
SS###SSSSS
S##  #SSSS
S# E #SSSS
S##C ##SSS
S## C #SSS
S#XC  #SSS
S#XXCX#SSS
S######SSS
SSSSSSSSSS