SSS####SSD
SSS#  #SSS
S###C ##SS
S#  F E#SS
S#  F  #SS
S#  F ##SS
S###F #SSS
SSS#X##SSS
SSS###SSSS
SSSSSSSSSS
