SSSSSSSSSD
S######SSS
SS#    ##S
S##X##C #S
S# XXC  #S
S#  #C  #S
S#  E ###S
S######SSS
SSSSSSSSSS
SSSSSSSSSS
