SSSSSSSSSD
######SSSS
#    #SSSS
# CCC##SSS
#  #XX###S
##  XXC #S
S# E    #S
S########S
SSSSSSSSSS
SSSSSSSSSS

