SSSSSSSSSD
SS######SS
SS#    #SS
###CCC #SS
#E CXX #SS
# CXXX##SS
####  #SSS
SSS####SSS
SSSSSSSSSS
SSSSSSSSSS
