##########
#b  X   X#
#        #
#   C    #
#  P     #
#     p# #
#  C   #C#
#     O# #
#  X   #E#
##########
